11111111111111111111111111111111111111111111111111
10000000000000100000000001000000000000100000000001
10000000000000100000000001000000000000100000000001
10000000000000100000000001000000000000100000000001
10000000000000100000000001000000000000100000000001
10000000000000100000000001000000000000100000000001
10000000000000100000000001000000000000100000000001
10000000000000100000000001000000000000100000000001
10000000000000100000000001000000000000100000000001
10000000000000100000000001000000000000100000000001
10000000000000100000000001000000000000100000000001
10000000000000100000000001000000000000100000000001
10000000000000100000000001000000000000100000000001
11111111111111011111111111111111111111011111111111
10000000000000100000000001000000000000100000000001
10000000000000100000000001000000000000100000000001
10000000000000100000000001000000000000100000000001
10000000000000100000000001000000000000100000000001
10000000000000100000000001000000000000100000000001
10000000000000100000000001000000000000100000000001
10000000000000100000000001000000000000100000000001
10000000000000100000000001000000000000100000000001
10000000000000100000000001000000000000100000000001
10000000000000100000000001000000000000100000000001
11111111111111111111111100000000000000100000000001
10000000000000100000000000111111111111111111111111
10000000000000100000000010000000000000100000000001
10000000000000100000000010000000000000100000000001
10000000000000100000000010000000000000100000000001
10000000000000100000000010000000000000100000000001
10000000000000100000000010000000000000100000000001
10000000000000100000000010000000000000100000000001
10000000000000100000000010000000000000100000000001
10000000000000100000000010000000000000100000000001
10000000000000100000000010000000000000100000000001
10000000000000100000000010000000000000100000000001
10000000000000100000000010000000000000100000000001
10000000000000100000000010000000000000100000000001
11111111111111011111111111111111111111011111111111
10000000000000100000000010000000000000100000000001
10000000000000100000000010000000000000100000000001
10000000000000100000000010000000000000100000000001
10000000000000100000000010000000000000100000000001
10000000000000100000000010000000000000100000000001
10000000000000100000000010000000000000100000000001
10000000000000100000000010000000000000100000000001
10000000000000100000000010000000000000100000000001
10000000000000100000000010000000000000100000000001
10000000000000100000000010000000000000100000000001
11111111111111111111111111111111111111111111111111
